20, 0, 0, 0, 0, 0, 0
19, 1, 0, 0, 0, 0, 0
17, 3, 0, 0, 0, 0, 0
14, 5, 1, 0, 0, 0, 0
9, 7, 3, 0, 0, 0, 0
7, 6, 6, 1, 0, 0, 0
4, 6, 6, 3, 1, 0, 0
2, 6, 7, 4, 1, 0, 0
1, 4, 6, 6, 2, 1, 0
1, 2, 5, 8, 2, 2, 0
1, 2, 4, 7, 3, 2, 1
1, 1, 4, 4, 4, 4, 2
